1 1 1 1 1 1 1 3 3 3 3 3 1 1 1 1 1 1 1 1
1 0 0 0 0 0 0 0 0 0 0 0 0 0 0 0 0 0 0 1
1 0 0 0 0 0 0 0 0 0 0 0 0 0 0 0 0 0 0 1
1 0 0 0 0 0 0 0 0 1 0 0 0 0 0 0 0 0 0 1
4 0 0 0 0 0 0 1 1 1 1 0 0 0 0 0 0 0 0 5
4 0 0 0 0 0 0 1 1 1 1 1 0 0 0 0 0 0 0 5
4 0 0 0 0 0 0 1 1 1 1 1 0 0 0 0 0 0 0 5
4 0 0 0 0 0 0 1 1 1 1 1 0 0 0 0 0 0 0 5
1 0 0 0 0 0 0 0 1 1 1 0 0 0 0 0 0 0 0 1
1 0 0 0 0 0 0 0 0 0 0 0 0 0 0 0 0 0 0 1
1 0 0 0 0 0 0 0 0 0 0 0 0 0 0 0 0 0 0 1
1 1 1 1 1 1 1 1 1 1 1 1 1 1 1 1 1 1 1 1